# Resources from graph.properties
alreadyConnected=Düğümler zaten bağlı
cancel=İptal
close=Kapat
collapse-expand=Daralt/Genişlet
containsValidationErrors=Doğrulama hataları içeriyor
done=Tamam
doubleClickOrientation=Yönü Değiştirmek için Çift Tıklayın
error=Hata
errorSavingFile=Dosya kaydedilirken hata oluştu
ok=OK
updatingDocument=Belge Güncelleniyor. Lütfen bekleyiniz...
updatingSelection=Seçim Güncelleniyor. Lütfen bekleyiniz...
# Custom resources
about=Hakkında
actualSize=Gerçek boyutu
add=Ekle
addLayer=Katman ekle
addProperty=Özellik ekle
addToExistingDrawing=Mevcut çizime ekle
addWaypoint=Ara nokta ekle
advanced=Gelişmiş
align=Hizala
alignment=Hizalama
allChangesLost=Tüm değişiklikler kaybolacak!
angle=Açı
apply=Uygula
arc=Kavis
arrange=Düzenle
arrow=Ok
arrows=Oklar
automatic=Otomatik
autosave=Otomatik Kaydetme
autosize=Otomatik Boyutlandırma
back=Geri
background=Arka plan
backgroundColor=Arka plan rengi
backgroundImage=Arka plan resmi
basic=Temel
block=Blok
blockquote=Blok alıntı
bold=Kalın
border=Kenar
borderWidth=Kenar genişliği
borderColor=Kenar rengi
bottom=Alt
bottomAlign=Alt hizalama
bottomLeft=Sol alt
bottomRight=Sağ alt
bulletedList=Maddeli liste
cannotOpenFile=Dosya açılamıyor
center=Merkez
change=Değiştir
changeOrientation=Yönü değiştir
circle=Daire
classic=Klasik
clearDefaultStyle=Varsayılan stili temizle
clearWaypoints=Clear Waypoints
clipart=Küçük resim
collapse=Daralt
collapseExpand=Daralt/Genişlet
collapsible=Daraltılabilir
comic=Comic
connect=Bağla
connection=Bağlantı
connectionPoints=Bağlantı noktaları
connectionArrows=Bağlantı okları
constrainProportions=Oranları Kısıtla
copy=Kopyala
copyConnect=Bağlantıda kopyala
copySize=Kopya Boyutu
create=Oluşturmak
curved=Kavisli
custom=Custom
cut=Kes
dashed=Kesikli
decreaseIndent=Girintiyi azalt
default=Varsayılan
delete=Sil
deleteColumn=Sütunu sil
deleteRow=Sırayı sil
diagram=Diyagram
diamond=Elmas
diamondThin=Elmas (ince)
direction=Yön
distribute=Dağıtmak
divider=Bölücü
documentProperties=Döküman özellikleri
dotted=Noktalı
dpi=DPI
drawing=Çizim{1}
drawingEmpty=Çizim boş
drawingTooLarge=Çizim çok büyük
duplicate=Kopyala
duplicateIt=Yinelenen {1}
east=Doğu
edit=Düzenle
editData=Verileri düzenle
editDiagram=Şemayı düzenle
editImage=Resmi düzenle
editLink=Bağlantıyı düzenle
editStyle=Stili düzenle
editTooltip=İpucunu düzenle
enterGroup=Grup gir
enterValue=Değer gir
enterName=İsim gir
enterPropertyName=Özellik adını girin
entityRelation=Varlık ilişkisi
exitGroup=Gruptan çık
expand=Genişlet
export=Dışa aktar
extras=Ekstralar
file=Dosya
fileNotFound=Dosya bulunamadı
filename=Dosya adı
fill=Doldur
fillColor=Dolgu Rengi
fitPage=Bir Sayfa
fitPageWidth=Sayfa Genişliği
fitTwoPages=İki Sayfa
fitWindow=Pencereyi Sığdır
flip=Çevir
flipH=Yatay çevir
flipV=Dikey çevir
font=Yazı tipi
fontFamily=Font ailesi
fontColor=Yazı rengi
fontSize=Yazı boyutu
format=Biçim
formatPanel=Biçim paneli
general=Genel
formatPdf=PDF
formatPng=PNG
formatGif=GIF
formatJpg=JPEG
formatSvg=SVG
formatXml=XML
formatted=Biçimlendirilmiş
formattedText=Biçimlendirilmiş metin
gap=Açıklık
glass=Glass
general=Genel
global=Küresel
gradient=Gradyan
gradientColor=Renk
grid=Izgara
gridSize=Izgara boyutu
group=Grup
guides=Kılavuzlar
heading=Başlık
height=Yükseklik
help=Yardım
hide=Gizle
hideIt=Gizle {1}
hidden=Gizlenmiş
home=Ev
horizontal=Yatay
horizontalFlow=Yatay Akış
horizontalTree=Yatay Ağaç
html=HTML
id=ID
image=Resim
images=Resimler
import=İçe aktar
increaseIndent=Girintiyi Artır
insert=Ekle
insertColumnBefore=Sola Sütun Ekle
insertColumnAfter=Sağa Sütun Ekle
insertHorizontalRule=Insert Horizontal Rule
insertImage=Resim ekle
insertLink=Bağlantı Ekle
insertRowBefore=Yukarıya Satır Ekle
insertRowAfter=Aşağıya Satır Ekle
invalidInput=Geçersiz Giriş
invalidName=Geçersiz isim
invalidOrMissingFile=Geçersiz veya eksik dosya
isometric=Isometric
italic=İtalik
layers=Katmanlar
landscape=Peyzaj
laneColor=Şerit rengi
layout=Düzen
left=Ayrıldı
leftAlign=Sola Hizala
leftToRight=Soldan sağa
line=Çizgi
link=Bağlantı
lineJumps=Çizgi atlamaları
lineend=Line End
lineheight=Line Height
linestart=Line Start
linewidth=Linewidth
loading=Yükleniyor
lockUnlock=Kilitle/Kilidi Aç
manual=Manuel
middle=Orta
misc=Misc
more=Daha
moreResults=Daha fazla sonuç
move=Move
moveSelectionTo=Move Selection to {1}
navigation=Navigasyon
new=Yeni
noColor=Renk yok
noFiles=Dosya yok
noMoreResults=Başka sonuç yok
none=Hiçbiri
noResultsFor='{1}' için sonuç yok
normal=Normal
north=Kuzey
numberedList=Numaralandırılmış Liste
opacity=Opaklık
open=Aç
openArrow=Açık Ok
openFile=Açık dosya
openLink=Linki aç
openSupported=Desteklenen biçim, bu yazılımdan kaydedilen .dygrm dosyalarıdır.
openInNewWindow=Yeni pencerede aç
openInThisWindow=Bu pencerede aç
options=Seçenekler
organic=Organik
orthogonal=Ortogonal
outline=Anahat
oval=Oval
pages=Sayfalar
pageView=Sayfa görünümü
pageScale=Sayfa ölçeği
pageSetup=Sayfa ayarı
panTooltip=Kaydırmak için Boşluk+Sürükle
paperSize=Kağıt boyutu
paste=Yapıştır
pasteHere=Buraya yapıştırın
pasteSize=Yapıştırma Boyutu
pattern=Model
perimeter=Çevre
placeholders=Yer tutucular
plusTooltip=Bağlanmak ve klonlamak için tıklayın (ctrl+klonlamak için tıklayın, shift+bağlanmak için tıklayın). Bağlanmak için sürükleyin (klonlamak için ctrl+sürükle).
portrait=Portre
position=Pozisyon
posterPrint=Poster Baskı
preview=Ön izleme
print=Yazdır
radialTree=Radyal Ağaç
redo=Yeniden yap
removeFormat=Biçimlendirmeyi Temizle
removeFromGroup=Gruptan Kaldır
removeIt=Remove {1}
removeWaypoint=Remove Waypoint
rename=Yeniden isimlendirmek
renameIt={1} yeniden adlandır
replace=Yer değiştirmek
replaceIt={1} zaten var. Değiştirmek ister misiniz?
replaceExistingDrawing=Mevcut çizimi değiştir
reset=Sıfırla
resetView=Görünümü sıfırla
reverse=Tersi
right=Doğru
rightAlign=Sağa Hizala
rightToLeft=Sağdan sola
rotate=Döndür
rotateTooltip=Döndürmek için tıklayın ve sürükleyin, şekli yalnızca 90 derece döndürmek için tıklayın
rotation=Döndürme
sketch=Sketch
rounded=Yuvarlak
save=Kaydet
saveAs=Farklı kaydet
saved=Kaydedildi
scrollbars=Scrollbars
search=Ara
searchShapes=Şekilleri Ara
selectAll=Hepsini Seç
selectEdges=Kenarları Seç
selectFont=Yazı Tipi Seçin
selectNone=Hiçbirini Seçme
selectVertices=Köşeleri Seç
setAsDefaultStyle=Varsayılan Stil Olarak Ayarla
shadow=Gölge
shape=Şekil
sharp=Keskin
sidebarTooltip=Genişletmek için tıkla. Şekilleri diyagrama tut ve sürükle. Seçimi değiştirmek için Shift+click. Bağlatarak eklemek için Alt+click.
simple=Basit
simpleArrow=Basit Ok
size=Boyut
solid=Solid
sourceSpacing=Kaynak Aralığı
south=Güney
spacing=Aralık
straight=Düz
strikethrough=Üstü çizili
strokeColor=Çizgi rengi
style=stil
subscript=Subscript
superscript=Superscript
table=Table
targetSpacing=Hedef Aralığı
text=Metin
textAlignment=Metin hizalama
textOpacity=Metin Opaklığı
toBack=Geriye götür
toFront=Öne getir
tooltips=Araç ipuçları
top=Üst
topAlign=Üst Hizalama
topLeft=Sol üst
topRight=Sağ üst
transparent=Şeffaf
turn=Şekli yalnızca 90° döndür
uml=UML
underline=Altını çiz
undo=Geri al
ungroup=Grubu çöz
url=URL
untitledLayer=Adsız Katman
vertical=Dikey
verticalFlow=Dikey Akış
verticalTree=Dikey Ağaç
view=Görüntü
waypoints=Ara noktalar
west=Batı
width=Genişlik
wordWrap=Kelime Sarma
writingDirection=Yazı Yönü
zoom=Yakınlık
zoomIn=Yakınlaştır
zoomOut=Uzaklaştır
